1 1 -1 1 -1 2 1 -1 -1
1 1 -1 1 1 2 1 -1 2
1 -1 -1 -1 -1 2 -1 -1 -1
1 -1 -1 1 -1 2 -1 -1 2
-1 -1 -1 -1 1 2 -1 1 -1
-1 -1 -1 -1 -1 2 -1 1 2
-1 1 -1 1 1 2 1 1 -1
-1 1 -1 -1 1 2 1 1 2
1 1 2 -1 -1 2 1 -1 2
1 1 2 -1 1 2 -1 -1 2
1 -1 -1 -1 1 -1 1 1 -1
1 -1 -1 -1 -1 -1 -1 1 -1
-0.999 -0 0 -0.999 -0 1 -0.999 0.75 1
-0.999 -0 0 -0.999 0.75 1 -0.999 0.75 0
